1111111111111111111
11000000P0000000111
1111110011111111111
1111110111111111111
111110000C111111111
1111000111111111111
1000000000000000001
1111111111111000111
1E00000000000000001
1111111111111111111