1111111111111111111
1100000C00000000111
1111110011111111111
1111110111111111111
11111000C1111111111
11110C0111111111111
10000P00000C0000C01
111111111111100C111
1E0000000C000C00011
1111111111111111111