111111111111111111111
1110000000C0000000001
100000100000000111111
111110101111111111111
1110000P0000000111111
11C00000100000E111111
111111111111111111111
