111111111
1100C111
11011111
11000001
1000P111
1E000011
11111111