1111111111111111111
1100000C00000000111
1111110011111111111
1111110111111111111
11111000C1111111111
11110C0111111111111
100000P0000C0000C01
111111111111100C111
10000E000C000C00001
1111111111111111111